TERRAIN:
S1 S1 S1 S2 S1 S1 S1 S1 S1 S1 S1 S1 S1 S1
S1 S1 S1 S2 S1 S1 S1 S1 S1 S1 S1 S1 S1 S1
S1 S2 S2 S1 S2 S1 S1 S1 S2 S2 S2 S2 S1 S1
S1 S2 S2 S2 S2 S1 S1 S1 S2 S2 S2 S2 S1 S1
S1 S1 S1 S1 S1 S1 S1 S1 S1 S1 S1 S1 S1 S1

OBJECTS:
teleport 1 1 beach 3 3
teleport 3 3 lab 2 2
