TERRAIN:
S1 S1 S1 S2 S1 S1 S1 S1 S1 S1 S1 S1 S1 S1
S1 S1 S1 S2 S1 S1 S1 S1 S1 S1 S1 S1 S1 S1
S1 S2 S2 S1 S2 S1 S1 S1 S2 S2 S2 S2 S1 S1
S1 S2 S2 S2 S2 S1 S1 S1 S2 S2 S2 S2 S1 S1
S1 S2 S2 S2 S2 S1 S1 S1 S2 S2 S2 S2 S1 S1

OBJECTS:


EVENTS:
teleport 3 3 assets/maps/beach.txt 7 7

NPCS:
PROFESSOR 4 2 ProfessorOak
